#,E,#,#,#,#,#,#,#,#
#, ,#,#,#,#,#,#,#,#
#, ,#,#,#,#,#,#,#,#
#, ,#,#,#,#,#,#,#,#
#, , , , , , , ,#,#
#,#,#,#,#,#,#, ,#,#
#,#,#,#,#,#,#, ,#,#
#,#,#,#,#,#,#, ,#,#
#,#,#,#,#,#,#, ,#,#
#,#,#,#,#,#,#, ,S,#
